1111111111111111111111111111111111
1C000C000000000C00000C000000000001
101001010010C000101001000000010101
101001001010101000100100000001E101
11000C000C00C0000000000C000000P001
1111111111111111111111111111111111