1111111111111
100100000C111
1000011111111
1P0011E000001
1000011111001
1000011011001
1000010001111
1000111110011
1111111111111