1111111111111111111111111111111111
100P0000000000C00000C00000E0000011
1010010000010000010100100000001011
101001C0101C1010001001000000010101
1000000000000000000000000000000001
1111111111111111111111111111111111