1111111111111
100C000000C01
100C01C111001
1P00C100E0101
1111111111111